BULGĀRU VALODA
e — kā krievu э (latviešu šaurais e)
щ — št
ъ — kā krievu a, o neuzsvērtā zilbē
ČEHU VALODA
ě — je (e ar iepriekšējā līdzskaņa mīkstinājumu)
ň — ņ
ř — rž, rš
ů — ū
GOTU VALODA
e — ē
ei — ī
o — ō
q — kv
ƕ — hv (viena ionēma)
þ — kā angļu th
GRIEĶU (SENGRIEĶU) VALODA — LATĪŅU TRANSKRIPCIJĀ
ē (η) — plats ē
ō (ω) — plats ō
ei (ει) — šaurs ē > i
ou (oυ) — šaurs ō > ū
y (υ) — aptuveni kā vācu ū
HETU VALODA
h — laringālis
t/d
k/g — nešķir balsīgos un nebalsīgos līdzskaņus; apzī-
p/b mējumi mijas
HOLANDIEŠU VALODA
ae — ā
au — oṵ
eeu — ēṵ
ie — ī